0,0,0,0,0,0,0,0,0,0,0,0,0,0,0,0,0,0,0,0,0,0,0,0,0,0,0,0,0,0,0,0,0,0,0,0,0,0,0,0,0,0,0,0,0,0,0,0,0,0,0,0,0,0,0,0,0,0,0,0,0,0,0,0,0,0,0,0,0,0,0,0,0,0,0,0,0,0,0,0,0,0,0,0,0,0,0,0,0,0,0,0,0,0,0,0,0,0,0,0,0,0,0,0,0,0,0,0,0,0,0,0,0,0,0,0,0,0,0,0,0,0,0,0,0,0,0,0,0,0,0,0,0,0,0,0,0,0,0,0,0,0,0,0,0,0,0,0,0,0
0,0,34,34,34,34,34,34,34,34,34,34,34,0,0,0,0,0,0,0,0,0,34,34,34,34,34,34,34,34,34,34,99,0,0,0,0,0,0,0,0,0,99,99,99,99,99,99,99,99,99,99,99,0,0,0,0,0,0,0,0,0,99,99,99,99,99,99,99,99,99,99,99,0,0,0,0,0,0,0,0,0,99,99,99,99,99,99,99,99,99,99,99,0,0,0,0,0,0,0,0,0,105,105,105,105,105,105,105,105,105,105,105,0,0,0,0,0,0,0,0,0,105,105,105,105,105,105,105,105,105,105,105,105,105,105,105,105,105,105,105,105,105,105,105,105,105,105,0,0
0,34,0,0,0,0,0,0,0,0,0,0,0,34,0,0,0,0,0,0,0,34,0,0,0,0,0,0,0,0,0,0,0,99,0,0,0,0,0,0,0,99,0,0,0,0,0,0,0,0,0,0,0,99,0,0,0,0,0,0,0,99,0,0,0,0,0,0,0,0,0,0,0,99,0,0,0,0,0,0,0,99,0,0,0,0,0,0,0,0,0,0,0,105,0,0,0,0,0,0,0,105,0,0,0,0,0,0,0,0,0,0,0,105,0,0,0,0,0,0,0,105,0,0,0,0,0,0,0,0,0,0,0,0,0,0,0,0,0,0,0,0,0,0,0,0,0,0,105,0
34,0,0,0,0,0,0,0,0,0,0,0,0,0,34,0,0,0,0,0,34,0,0,0,0,0,0,0,0,0,0,0,0,0,99,0,0,0,0,0,99,0,0,0,0,0,0,0,0,0,0,0,0,0,99,0,0,0,0,0,99,0,0,0,0,0,0,0,0,0,0,0,0,0,99,0,0,0,0,0,99,0,0,0,0,0,0,0,0,0,0,0,0,0,105,0,0,0,0,0,105,0,0,0,0,0,0,0,0,0,0,0,0,0,105,0,0,0,0,0,105,0,0,0,0,0,0,0,0,0,0,0,0,0,0,0,0,0,0,0,0,0,0,0,0,0,0,0,0,105
0,0,0,0,0,0,0,0,0,0,0,0,0,0,0,34,0,0,0,34,0,0,0,0,0,0,0,0,0,0,0,0,0,0,0,34,0,0,0,99,0,0,0,0,0,0,0,0,0,0,0,0,0,0,0,99,0,0,0,99,0,0,0,0,0,0,0,0,0,0,0,0,0,0,0,99,0,0,0,99,0,0,0,0,0,0,0,0,0,0,0,0,0,0,0,105,0,0,0,105,0,0,0,0,0,0,0,0,0,0,0,0,0,0,0,105,0,0,0,105,0,0,0,0,0,0,0,0,0,105,105,105,105,105,105,105,105,105,0,0,0,0,0,0,0,0,0,0,0,0
0,0,0,0,0,0,0,0,0,0,0,0,0,0,0,0,34,34,34,0,0,0,0,0,0,0,99,99,99,0,0,0,0,0,0,0,99,99,99,0,0,0,0,0,0,0,34,34,34,0,0,0,0,0,0,0,99,99,99,0,0,0,0,0,0,0,105,105,105,0,0,0,0,0,0,0,99,99,99,0,0,0,0,0,0,0,34,34,34,0,0,0,0,0,0,0,105,105,105,0,0,0,0,0,0,0,105,105,105,0,0,0,0,0,0,0,105,105,105,0,0,0,0,0,0,0,105,105,105,0,0,0,0,0,0,0,0,0,105,105,105,0,0,0,0,0,0,0,0,0
0,0,0,0,0,0,0,0,0,0,0,0,0,0,0,0,0,0,0,0,0,0,0,0,0,99,0,0,0,99,0,0,0,0,0,0,0,0,0,0,0,0,0,0,0,99,0,0,0,34,0,0,0,0,0,0,0,0,0,0,0,0,0,0,0,105,0,0,0,105,0,0,0,0,0,0,0,0,0,0,0,0,0,0,0,105,0,0,0,105,0,0,0,0,0,0,0,0,0,0,0,0,0,0,0,105,0,0,0,105,0,0,0,0,0,0,0,0,0,0,0,0,0,0,0,105,0,0,0,0,0,0,0,0,0,0,0,0,0,0,0,105,0,0,0,0,0,0,0,0
0,0,0,0,0,0,0,0,0,0,0,0,0,0,0,0,0,0,0,0,0,0,0,0,0,99,0,0,0,99,0,0,0,0,0,0,0,0,0,0,0,0,0,0,0,99,0,0,0,99,0,0,0,0,0,0,0,0,0,0,0,0,0,0,0,105,0,0,0,105,0,0,0,0,0,0,0,0,0,0,0,0,0,0,0,105,0,0,0,105,0,0,0,0,0,0,0,0,0,0,0,0,0,0,0,105,0,0,0,105,0,0,0,0,0,0,0,0,0,0,0,0,0,0,0,105,0,0,0,0,0,0,0,0,0,0,0,0,0,0,0,105,0,0,0,0,0,0,0,0
0,0,0,0,0,0,0,0,0,0,0,0,0,0,0,0,0,0,0,0,0,0,0,0,0,99,0,0,0,99,0,0,0,0,0,0,0,0,0,0,0,0,0,0,0,99,0,0,0,99,0,0,0,0,0,0,0,0,0,0,0,0,0,0,0,105,0,0,0,105,0,0,0,0,0,0,0,0,0,0,0,0,0,0,0,105,0,0,0,105,0,0,0,0,0,0,0,0,0,0,0,0,0,0,0,105,0,0,0,105,0,0,0,0,0,0,0,0,0,0,0,0,0,0,0,105,0,0,0,0,0,0,0,0,0,0,0,0,0,0,0,105,0,0,0,0,0,0,0,0
0,0,0,0,0,0,0,0,0,0,0,0,0,0,0,0,0,0,0,0,0,0,0,0,0,99,0,0,0,99,0,0,0,0,0,0,0,0,0,0,0,0,0,0,0,99,0,0,0,99,0,0,0,0,0,0,0,0,0,0,0,0,0,0,0,105,0,0,0,105,0,0,0,0,0,0,0,0,0,0,0,0,0,0,0,105,0,0,0,105,0,0,0,0,0,0,0,0,0,0,0,0,0,0,0,105,0,0,0,105,0,0,0,0,0,0,0,0,0,0,0,0,0,0,0,105,0,0,0,0,0,0,0,0,0,0,0,0,0,0,0,105,0,0,0,0,0,0,0,0
0,0,0,0,0,0,0,0,0,0,0,0,0,0,0,0,0,0,0,0,0,0,0,0,0,99,0,0,0,99,0,0,0,0,0,0,0,0,0,0,0,0,0,0,0,99,0,0,0,99,0,0,0,0,0,0,0,0,0,0,0,0,0,0,0,105,0,0,0,105,0,0,0,0,0,0,0,0,0,0,0,0,0,0,0,105,0,0,0,105,0,0,0,0,0,0,0,0,0,0,0,0,0,0,0,105,0,0,0,105,0,0,0,0,0,0,0,0,0,0,0,0,0,0,0,105,0,0,0,0,0,0,0,0,0,0,0,0,0,0,0,105,0,0,0,0,0,0,0,0
0,0,0,0,0,0,0,0,0,0,0,0,0,0,0,0,34,34,34,0,0,0,0,0,0,0,99,99,99,0,0,0,0,0,0,0,99,99,99,0,0,0,0,0,0,0,34,34,34,0,0,0,0,0,0,0,99,99,99,0,0,0,0,0,0,0,105,105,105,0,0,0,0,0,0,0,99,99,99,0,0,0,0,0,0,0,34,34,34,0,0,0,0,0,0,0,105,105,105,0,0,0,0,0,0,0,105,105,105,0,0,0,0,0,0,0,105,105,105,0,0,0,0,0,0,0,105,105,105,0,0,0,0,0,0,0,0,0,105,105,105,0,0,0,0,0,0,0,0,0
0,0,0,0,0,0,0,0,0,0,0,0,0,0,0,34,0,0,0,34,0,0,0,0,0,0,0,0,0,0,0,0,0,0,0,99,0,0,0,99,0,0,0,0,0,0,0,0,0,0,0,0,0,0,0,99,0,0,0,99,0,0,0,0,0,0,0,0,0,0,0,0,0,0,0,99,0,0,0,99,0,0,0,0,0,0,0,0,0,0,0,0,0,0,0,105,0,0,0,105,0,0,0,0,0,0,0,0,0,0,0,0,0,0,0,105,0,0,0,105,0,0,0,0,0,0,0,0,0,105,105,105,105,105,105,105,105,105,0,0,0,0,0,0,0,0,0,0,0,0
34,0,0,0,0,0,0,0,0,0,0,0,0,0,34,0,0,0,0,0,34,0,0,0,0,0,0,0,0,0,0,0,0,0,99,0,0,0,0,0,99,0,0,0,0,0,0,0,0,0,0,0,0,0,99,0,0,0,0,0,99,0,0,0,0,0,0,0,0,0,0,0,0,0,99,0,0,0,0,0,99,0,0,0,0,0,0,0,0,0,0,0,0,0,105,0,0,0,0,0,105,0,0,0,0,0,0,0,0,0,0,0,0,0,105,0,0,0,0,0,105,0,0,0,0,0,0,0,0,0,0,0,0,0,0,0,0,0,0,0,0,0,0,0,0,0,0,0,0,105
0,34,0,0,0,0,0,0,0,0,0,0,0,34,0,0,0,0,0,0,0,34,0,0,0,0,0,0,0,0,0,0,0,99,0,0,0,0,0,0,0,99,0,0,0,0,0,0,0,0,0,0,0,99,0,0,0,0,0,0,0,99,0,0,0,0,0,0,0,0,0,0,0,99,0,0,0,0,0,0,0,99,0,0,0,0,0,0,0,0,0,0,0,105,0,0,0,0,0,0,0,105,0,0,0,0,0,0,0,0,0,0,0,105,0,0,0,0,0,0,0,105,0,0,0,0,0,0,0,0,0,0,0,0,0,0,0,0,0,0,0,0,0,0,0,0,0,0,105,0
0,0,34,34,34,34,34,34,34,34,34,34,34,0,0,0,0,0,0,0,0,0,34,34,34,34,34,34,34,34,34,34,99,0,0,0,0,0,0,0,0,0,99,99,99,99,99,99,99,99,99,99,99,0,0,0,0,0,0,0,0,0,99,99,99,99,99,99,99,99,99,99,99,0,0,0,0,0,0,0,0,0,99,99,99,99,99,99,99,99,99,99,105,0,0,0,0,0,0,0,0,0,105,105,105,105,105,105,105,105,105,105,105,0,0,0,0,0,0,0,0,0,105,105,105,105,105,105,105,105,105,105,105,105,105,105,105,105,105,105,105,105,105,105,105,105,105,105,0,0
0,0,0,0,0,0,0,0,0,0,0,0,0,0,0,0,0,0,0,0,0,0,0,0,0,0,0,0,0,0,0,0,0,0,0,0,0,0,0,0,0,0,0,0,0,0,0,0,0,0,0,0,0,0,0,0,0,0,0,0,0,0,0,0,0,0,0,0,0,0,0,0,0,0,0,0,0,0,0,0,0,0,0,0,0,0,0,0,0,0,0,0,0,0,0,0,0,0,0,0,0,0,0,0,0,0,0,0,0,0,0,0,0,0,0,0,0,0,0,0,0,0,0,0,0,0,0,0,0,0,0,0,0,0,0,0,0,0,0,0,0,0,0,0,0,0,0,0,0,0
